#####################
#S  #       #       #
### ### ### ##### # #
# #     # #     # # #
# ####### ##### # ###
#           #   #   #
# ####### ### ### # #
# #     #     # # # #
# # ### ####### # # #
# # #   #       # # #
# # # # ##### # # # #
# # # #   #   # # # #
# ### ### # ##### # #
#   # #   #       # #
### # # ##### ##### #
# #   # #   # #   # #
# ##### # # ### # # #
# #   # # #     #   #
# # # # # ######### #
#   #     #        E#
#####################